XXXXXXXXXXXXXXXXXXXXXXXXXXXX
XOOOOOOOOOOOOXXOOOOOOOOOOOOX
XOXXXXOXXXXXOXXOXXXXXOXXXXOX
XOXXXXOXXXXXOXXOXXXXXOXXXXOX
XOXXXXOXXXXXOXXOXXXXXOXXXXOX
XOOOOOOOOOOOOOOOOOOOOOOOOOOX
XOXXXXOXXOXXXXXXXXOXXOXXXXOX
XOXXXXOXXOXXXXXXXXOXXOXXXXOX
XOOOOOOXXOOOOXXOOOOXXOOOOOOX
XXXXXXOXXXXXOXXOXXXXXOXXXXXX
XXXXXXOXXXXXOXXOXXXXXOXXXXXX
XXXXXXOXXOOOOOOOOOOXXOXXXXXX
XXXXXXOXXOXXXXXXXXOXXOXXXXXX
XXXXXXOXXOXXXXXXXXOXXOXXXXXX
OOOOOOOOOOXXXXXXXXOOOOOOOOOO
XXXXXXOXXOXXXXXXXXOXXOXXXXXX
XXXXXXOXXOXXXXXXXXOXXOXXXXXX
XXXXXXOXXOOOOOOOOOOXXOXXXXXX
XXXXXXOXXOXXXXXXXXOXXOXXXXXX
XXXXXXOXXOXXXXXXXXOXXOXXXXXX
XOOOOOOOOOOOOXXOOOOOOOOOOOOX
XOXXXXOXXXXXOXXOXXXXXOXXXXOX
XOXXXXOXXXXXOXXOXXXXXOXXXXOX
XOOOXXOOOOOOOOOOOOOOOOXXOOOX
XXXOXXOXXOXXXXXXXXOXXOXXOXXX
XXXOXXOXXOXXXXXXXXOXXOXXOXXX
XOOOOOOXXOOOOXXOOOOXXOOOOOOX
XOXXXXXXXXXXOXXOXXXXXXXXXXOX
XOXXXXXXXXXXOXXOXXXXXXXXXXOX
XOOOOOOOOOOOOOOOOOOOOOOOOOOX
XXXXXXXXXXXXXXXXXXXXXXXXXXXX